11111111111111111
1E001100000000001
11101C01101101101
10000101C01000001
10110101101010101
10110101001010101
10C00101001010101
101101010110C0001
10110001000010101
10C00101001010101
10101101001010C01
10100101001010101
10100101001010101
10000000000000001
101011011011C1101
1P000000000000001
11111111111111111
